colophon: Colophon
content: content Content
name: Name
google: Google
blind: blind
screen: screen
collecting: collecting
used: used
let: let
leaders: Leaders
notice: notice
alternatives: alternatives
consortium: Consortium
names: Names
current: current
mozilla: Mozilla
main: main
website: website
comply: comply
help: Help help
for: For
integrations: Integrations
discover: Discover
view: view
increase: Increase
circumstances: circumstances
a: A
skipped: skipped
provided: provided
majority: majority
including: including
fully: fully
purpose: purpose
wide: Wide
click: click
order: order
adobe: Adobe
cookies: cookies
enhanced: enhanced
us: Us us
page: page
skip: Skip skip
reviewed: reviewed
some: Some
libraries: libraries
browser: browser
accessible: accessible
web: web Web
navigation: navigation
try: try
about: About
https: https
rewritten: rewritten
described: described
world: World
trying: trying
using: using
edge: Edge
device: device
operating: operating
we: We
reader: Reader
sort: sort
disabilities: disabilities
link: link
title: title
like: like
text: text
p: p
this: This
how: How
everyone: everyone
includes: includes
series: series
work: work
accessibility: Accessibility accessibility
firefox: Firefox
websites: websites
lot: lot
the: The
need: need
apis: APIs
more: More
problem: problem
keyboard: keyboard
appropriate: appropriate
chrome: Chrome
simplifying: simplifying
right: Right
levels: levels
logically: logically
enable: enable
stylesheets: stylesheets
implemented: implemented
glossary: Glossary
as: As
portable: Portable
part: part
find: find Find
background: background
evaluation: evaluation
uk: UK uk
except: except
going: going
contact: Contact
which: Which
copy: copy
community: community
files: Files
safari: Safari
conformance: conformance
problems: problems
see: see
where: Where
design: design
possible: possible
make: Make make
ongoing: ongoing
computer: computer
allow: allow
forms: forms
status: status
centre: Centre
jquery: jQuery
guidelines: guidelines Guidelines
file: file
hard: hard
disabling: disabling
browsers: browsers
software: software
sense: sense
attributes: attributes
process: process
context: context
designed: designed
rather: rather
people: people
pdf: PDF
details: details
pdfs: PDFs
collected: collected
change: Change
hubspot: hubspot
richer: richer
note: note
visible: visible
form: form
certain: certain
technology: technology
things: things
wcag: WCAG
easier: easier
microsoft: Microsoft
responsive: responsive
links: links
javascript: JavaScript
experience: experience
achieve: achieve
mouse: mouse
domain: Domain
well: well
standard: standard
card: card
sure: sure
use: use
hubspotcollectedformsworkaround: HubspotCollectedFormsWorkaround
document: Document
our: Our
nominet: nominet Nominet
working: working
receive: receive
given: given
reduced: reduced
your: Your
capabilities: capabilities
easy: easy
if: If
latest: latest
aim: aim
talking: talking
concerned: concerned
clear: Clear
readers: readers
know: know
apple: Apple
improvement: improvement
system: system
continually: continually
may: may
search: Search
aa: AA
review: review
read: read
cases: cases
available: available
modern: modern
com: com
email: email
credit: credit
stop: stop
acrobat: Acrobat
privacy: Privacy
standards: standards
in: In
site: site
explain: explain
terms: Terms
free: free
installed: installed
documents: documents
you: You
colours: colours
size: size
please: Please
